00010100000001010001000000000000000000000101010000000000000
11010111011101010111110111011101111111011101011101011101110
00000100010000000100000100010101010101010000000001010000010
01110111011101110111010111010111010101111101010101111101110
01000100000101000000010100000100000000010001010100010000010
01110111011111110101011111110111011101111101111111111101110
01010100000101010101010101000000010000010000010101010001010
11010111011101011111110101110101011101111101110101011101011
01000100000100000100000000010101010000010001000000000100000
01011111011101110111010111011111111101111101110111011111011
00000100000101000000010101010100010001000001000101000001000
01111111011111111111111101010111011101110101110101110111011
01010100000001010101010100000001010000000101000000010000000
01010111010111010101010101110111011101010111111101111101010
00000001010000000000000000010000010101010100010001010101010
11011101110101010101010101110101110111111101111101010111110
00010000010101010101010101010100000000000000010000000001000
11011111011111111111111111011101010101010111111111110111110
00000100000000000100000000000101010101010101010101010001000
11010111010101110101111111011111111111011101010101010111010
01010001010101000001010101000001000000010100000000000001010
01110111111111111101010101110111110101110101110101111111110
00000001000100010000000001010100000101000000010100010101010
11010111110101111101011101011111010111110111111101110101011
00010100000001010101010000010100010101000001000001000000010
01011111011101010111111111010111011101110111111111110111010
01010000010000000000000100000000000001000001010100000100000
01111111011111110111011111010101111101110111010111010111110
00000100010101010100010101010101010101000100000000010001010
01011111110101011111010101111111010111110111010101011111010
01000001000000000100000000000100000001000000010101000100000
11010111110111011111110111011111010111111111011111111111011
01010001010001000101000001000001010000010100000000010101000
01110111010111011101110111010111110101110111010111110101011
01000000000001000000010001010001010100000001010101010000000
01110101010111010101110111110111011101010111111101010111010
01010101010101010100000001000001000101010001010000000001010
01011111111101111101010111110111011111110111011101111111110
00010000000000010101010101000000000001000000000101010100000
11011101111111010111111101110101010111110101011101010111111
00000001010101000000000101010101010001010101000100000101010
11111111010101110111011101011111110111011111011101110101010
01010100000000010001000100000001000000010100000101000000000
01010111011101110111011101111111110101110111011111111111110
00000001000100000001000001010101010100000100000001010101000
01110111011101010111010111010101011101011111010111010101110
00010000000101010101010100000000000101000001010000000000010
01111111111111111101110111011101110111010111110101010101110
01010101010001000100000100010001010001010001010101010100000
01010101011101011111011111011101011111110111011111111101010
00000000000100010000010000010000000101000001000100000101010
11010111011111011101111101011111011101110111110101110111111
00010100000100000001000001000101010000000001000001010000000
11011111011111110111110101111101011101010111011101011101011
00000100010101010101000101010000010001010100010000000101000
11010111010101011101110111011101111101111111111111011111010
01010100000000010000000000010001000000000001010101000101010
01110111010111011101010101111101110101010111010101011101110
00000001010100000001010100010000000101010000000000000100000
