00010100010
01110111010
01000001000
01110111110
00000001010
01f10111010
01010100000
01111111011
00000001000
01010111411
01010000000
