0000000000010100000
0101010111010101110
0101010100000000010
0111111111110111110
0000000001000101000
0101010111110101110
0101010001000000010
1111110111111101110
0000000001010100010
1101011111010101110
0001010101000000010
0101110101011101110
0101000000000101000
0111110111011111010
0001010001010100010
0111010111110111011
0100000001000100000
0111010111110111011
0001010100000000000
