00010100010
01110111010
01000001000
01110111110
00000001010
01010111010
01010100000
0111111101
00000001000
01010111011
01010000000
